11111111
1CP000E1
1CCCCC01
100000C1
11111111