11111111111111
10000000000001
10000000000001
10000000000001
10000000000001
10000000000001
10000000000001
10000000000001
10000000000001
10000000000001
10000000000001
10000000000001
10000000000001
1000C000000001
10000000000001
100000000000E1
11100000P00001
10000000000001
11111111111111