00000000000000000000
01111111111111111110
01C0000C000000000010
01CC00000000P0000010
010000C0000000000010
01C00000000E00000010
01111111111111111110
00000000000000000000